28 31
1 1 1 1 1 1 1 1 1 1 1 1 1 1 1 1 1 1 1 1 1 1 1 1 1 1 1 1
1 3 3 3 3 5 3 3 3 3 3 3 3 1 1 3 3 3 3 3 3 3 5 3 3 3 3 1
1 3 1 1 1 1 3 1 1 1 1 1 3 1 1 3 1 1 1 1 1 3 1 1 1 1 3 1
1 4 1 1 1 1 3 1 1 1 1 1 3 1 1 3 1 1 1 1 1 3 1 1 1 1 4 1
1 3 1 1 1 1 3 1 1 1 1 1 3 1 1 3 1 1 1 1 1 3 1 1 1 1 3 1
1 3 3 3 3 3 3 3 3 3 3 3 3 3 3 3 3 3 3 3 3 3 3 3 3 3 3 1
1 3 1 1 1 1 3 1 1 3 1 1 1 1 1 1 1 1 3 1 1 3 1 1 1 1 3 1
1 3 1 1 1 1 3 1 1 3 1 1 1 1 1 1 1 1 3 1 1 3 1 1 1 1 3 1
1 3 3 3 3 3 3 1 1 3 3 3 3 1 1 3 3 3 3 1 1 3 3 3 3 3 3 1
1 1 1 1 1 1 3 1 1 1 1 1 0 1 1 0 1 1 1 1 1 3 1 1 1 1 1 1
1 1 1 1 1 1 3 1 1 1 1 1 0 1 1 0 1 1 1 1 1 3 1 1 1 1 1 1
1 1 1 1 1 1 3 1 1 0 0 0 0 0 0 0 0 0 0 1 1 3 1 1 1 1 1 1
1 1 1 1 1 1 3 1 1 0 1 1 1 0 0 1 1 1 0 1 1 3 1 1 1 1 1 1
1 1 1 1 1 1 3 1 1 0 1 0 0 0 0 0 0 1 0 1 1 3 1 1 1 1 1 1
0 0 0 0 0 0 3 0 0 0 1 0 0 6 0 0 0 1 0 0 0 3 0 0 0 0 0 0
1 1 1 1 1 1 3 1 1 0 1 0 0 0 0 0 0 1 0 1 1 3 1 1 1 1 1 1
1 1 1 1 1 1 3 1 1 0 1 1 1 1 1 1 1 1 0 1 1 3 1 1 1 1 1 1
1 1 1 1 1 1 3 1 1 0 0 0 0 0 0 0 0 0 0 1 1 3 1 1 1 1 1 1
1 1 1 1 1 1 3 1 1 0 1 1 1 1 1 1 1 1 0 1 1 3 1 1 1 1 1 1
1 1 1 1 1 1 3 1 1 0 1 1 1 1 1 1 1 1 0 1 1 3 1 1 1 1 1 1
1 3 3 3 3 3 3 3 3 3 3 3 3 1 1 3 3 3 3 3 3 3 3 3 3 3 3 1
1 3 1 1 1 1 3 1 1 1 1 1 3 1 1 3 1 1 1 1 1 3 1 1 1 1 3 1
1 3 1 1 1 1 3 1 1 1 1 1 3 1 1 3 1 1 1 1 1 3 1 1 1 1 3 1
1 4 3 3 1 1 3 3 3 3 3 3 3 0 0 3 3 3 3 3 3 3 1 1 3 3 4 1
1 1 1 3 1 1 3 1 1 3 1 1 1 1 1 1 1 1 3 1 1 3 1 1 3 1 1 1
1 1 1 3 1 1 3 1 1 3 1 1 1 1 1 1 1 1 3 1 1 3 1 1 3 1 1 1
1 3 3 3 3 3 3 1 1 3 3 3 3 1 1 3 3 3 3 1 1 3 3 3 3 3 3 1
1 3 1 1 1 1 1 1 1 1 1 1 3 1 1 3 1 1 1 1 1 1 1 1 1 1 3 1
1 3 1 1 1 1 1 1 1 1 1 1 3 1 1 3 1 1 1 1 1 1 1 1 1 1 3 1
1 3 3 3 3 5 3 3 3 3 3 3 3 3 3 3 3 3 3 3 3 3 5 3 3 3 3 1
1 1 1 1 1 1 1 1 1 1 1 1 1 1 1 1 1 1 1 1 1 1 1 1 1 1 1 1